Day,Market Participant,Equity Option Contracts,Equity Option Trade Count,Equity Option Notional,Index/Other Option Contracts,Index/Other Option Trade Count,Index/Other Option Notional,Total Option Contracts,Total Trade Count,Total Option Notional
2025-06-03,NYSE American Options (A),2717240,330628,864693758.000000,0,0,0.000000,2717240,330628,864693758.000000
2025-06-03,BOX Options (B),3113744,343886,2068871438.000000,0,0,0.000000,3113744,343886,2068871438.000000
2025-06-03,Cboe Options Exchange (C),5136199,817571,1819098545.000000,3996482,953522,11108152141.000000,9132681,1771093,12927250686.000000
2025-06-03,MIAX Emerald (D),1917629,352634,613814216.000000,0,0,0.000000,1917629,352634,613814216.000000
2025-06-03,Cboe EDGX Options Exchange (E),2342513,379023,588964984.000000,0,0,0.000000,2342513,379023,588964984.000000
2025-06-03,Nasdaq GEMX (H),2363530,309192,695229145.000000,1855,122,21628950.000000,2365385,309314,716858095.000000
2025-06-03,Nasdaq ISE (I),2784728,417314,1173263449.500000,31827,12489,259891548.000000,2816555,429803,1433154997.500000
2025-06-03,Nasdaq MRX (J),1436936,207552,383781474.000000,0,0,0.000000,1436936,207552,383781474.000000
2025-06-03,MIAX Options Exchange (M),3297174,592304,1021686011.000000,0,0,0.000000,3297174,592304,1021686011.000000
2025-06-03,NYSE Arca Options (N),5106837,703022,1922352625.000000,0,0,0.000000,5106837,703022,1922352625.000000
2025-06-03,MIAX Pearl (P),644874,83531,160152321.000000,0,0,0.000000,644874,83531,160152321.000000
2025-06-03,NASDAQ Options Market (Q),1440964,194862,436591060.000000,0,0,0.000000,1440964,194862,436591060.000000
2025-06-03,MIAX Sapphire (S),835100,138551,232951026.000000,0,0,0.000000,835100,138551,232951026.000000
2025-06-03,Nasdaq BX Options (T),784752,87886,137396659.000000,0,0,0.000000,784752,87886,137396659.000000
2025-06-03,Members Exchange (U),1604932,239349,437892778.000000,0,0,0.000000,1604932,239349,437892778.000000
2025-06-03,Cboe C2 Options Exchange (W),1313841,167064,312094509.000000,15619,4376,27137154.000000,1329460,171440,339231663.000000
2025-06-03,Nasdaq PHLX (X),3950328,408703,2450292367.000000,34669,14779,205297636.000000,3984997,423482,2655590003.000000
2025-06-03,Cboe BZX Options Exchange (Z),1740204,263264,619622667.000000,1251,333,3245786.000000,1741455,263597,622868453.000000
2025-06-02,NYSE American Options (A),2643097,285585,716196750.000000,0,0,0.000000,2643097,285585,716196750.000000
2025-06-02,BOX Options (B),2654997,288498,2029568348.000000,0,0,0.000000,2654997,288498,2029568348.000000
2025-06-02,Cboe Options Exchange (C),4489988,766739,1482429057.000000,3743188,938769,9514698660.000000,8233176,1705508,10997127717.000000
2025-06-02,MIAX Emerald (D),1757173,326296,511034884.000000,0,0,0.000000,1757173,326296,511034884.000000
2025-06-02,Cboe EDGX Options Exchange (E),2402792,359665,583463547.000000,0,0,0.000000,2402792,359665,583463547.000000
2025-06-02,Nasdaq GEMX (H),2128670,288063,533099025.000000,175,73,3287020.000000,2128845,288136,536386045.000000
2025-06-02,Nasdaq ISE (I),2591432,395964,911689427.500000,27772,11291,106739680.000000,2619204,407255,1018429107.500000
2025-06-02,Nasdaq MRX (J),1353581,196607,350977087.000000,0,0,0.000000,1353581,196607,350977087.000000
2025-06-02,MIAX Options Exchange (M),2836319,511357,808438193.000000,0,0,0.000000,2836319,511357,808438193.000000
2025-06-02,NYSE Arca Options (N),4584208,639352,1803090431.000000,0,0,0.000000,4584208,639352,1803090431.000000
2025-06-02,MIAX Pearl (P),572853,73336,126594047.000000,0,0,0.000000,572853,73336,126594047.000000
2025-06-02,NASDAQ Options Market (Q),1330324,186987,415812939.000000,0,0,0.000000,1330324,186987,415812939.000000
2025-06-02,MIAX Sapphire (S),1392960,228724,354906285.000000,0,0,0.000000,1392960,228724,354906285.000000
2025-06-02,Nasdaq BX Options (T),732314,82431,138335741.000000,0,0,0.000000,732314,82431,138335741.000000
2025-06-02,Members Exchange (U),1498994,225806,385784023.000000,0,0,0.000000,1498994,225806,385784023.000000
2025-06-02,Cboe C2 Options Exchange (W),1335705,157096,291834887.000000,10151,2839,23652454.000000,1345856,159935,315487341.000000
2025-06-02,Nasdaq PHLX (X),4005603,413519,2317511227.000000,30319,14406,196390320.000000,4035922,427925,2513901547.000000
2025-06-02,Cboe BZX Options Exchange (Z),1566073,235499,481508053.000000,1065,302,2990634.000000,1567138,235801,484498687.000000
2025-05-30,NYSE American Options (A),2927150,309582,875673310.000000,0,0,0.000000,2927150,309582,875673310.000000
2025-05-30,BOX Options (B),4202892,398669,2098882271.000000,0,0,0.000000,4202892,398669,2098882271.000000
2025-05-30,Cboe Options Exchange (C),6096688,955036,1631808526.000000,4312786,1079667,9745452998.000000,10409474,2034703,11377261524.000000
2025-05-30,MIAX Emerald (D),1687557,312355,446026092.000000,0,0,0.000000,1687557,312355,446026092.000000
2025-05-30,Cboe EDGX Options Exchange (E),3726207,484800,724670599.000000,0,0,0.000000,3726207,484800,724670599.000000
2025-05-30,Nasdaq GEMX (H),1990308,250314,443889548.000000,374,106,5383545.000000,1990682,250420,449273093.000000
2025-05-30,Nasdaq ISE (I),3625851,516978,1089023555.000000,31591,13281,162687971.000000,3657442,530259,1251711526.000000
2025-05-30,Nasdaq MRX (J),1635071,236057,439443772.000000,0,0,0.000000,1635071,236057,439443772.000000
2025-05-30,MIAX Options Exchange (M),5076769,804800,1243955998.000000,0,0,0.000000,5076769,804800,1243955998.000000
2025-05-30,NYSE Arca Options (N),6210056,767824,2084511702.000000,0,0,0.000000,6210056,767824,2084511702.000000
2025-05-30,MIAX Pearl (P),1315939,175902,294590672.000000,0,0,0.000000,1315939,175902,294590672.000000
2025-05-30,NASDAQ Options Market (Q),2392954,357623,655005242.000000,0,0,0.000000,2392954,357623,655005242.000000
2025-05-30,MIAX Sapphire (S),1762591,264692,383049732.000000,0,0,0.000000,1762591,264692,383049732.000000
2025-05-30,Nasdaq BX Options (T),964506,104183,169045967.000000,0,0,0.000000,964506,104183,169045967.000000
2025-05-30,Members Exchange (U),2051241,283163,439594115.000000,0,0,0.000000,2051241,283163,439594115.000000
2025-05-30,Cboe C2 Options Exchange (W),1658297,212465,317149658.000000,14332,3144,28692983.000000,1672629,215609,345842641.000000
2025-05-30,Nasdaq PHLX (X),5593926,444277,2863454105.000000,42066,17298,326615855.000000,5635992,461575,3190069960.000000
2025-05-30,Cboe BZX Options Exchange (Z),2217007,301802,591362316.000000,853,334,2446738.000000,2217860,302136,593809054.000000
2025-05-29,NYSE American Options (A),2508416,274450,879546824.000000,0,0,0.000000,2508416,274450,879546824.000000
2025-05-29,BOX Options (B),4111846,346837,5260797100.500000,0,0,0.000000,4111846,346837,5260797100.500000
2025-05-29,Cboe Options Exchange (C),5049471,834266,1511628894.000000,3764238,985458,7660775740.000000,8813709,1819724,9172404634.000000
2025-05-29,MIAX Emerald (D),1123291,217004,323253200.000000,0,0,0.000000,1123291,217004,323253200.000000
2025-05-29,Cboe EDGX Options Exchange (E),2922499,443223,683427792.800000,0,0,0.000000,2922499,443223,683427792.800000
2025-05-29,Nasdaq GEMX (H),1840557,225329,426733726.000000,167,83,3939880.000000,1840724,225412,430673606.000000
2025-05-29,Nasdaq ISE (I),3018249,435983,1145589340.700000,28588,12351,118928835.000000,3046837,448334,1264518175.700000
2025-05-29,Nasdaq MRX (J),1454588,210214,421823764.000000,0,0,0.000000,1454588,210214,421823764.000000
2025-05-29,MIAX Options Exchange (M),4160397,660650,1084763221.000000,0,0,0.000000,4160397,660650,1084763221.000000
2025-05-29,NYSE Arca Options (N),5174461,653354,1833397099.000000,0,0,0.000000,5174461,653354,1833397099.000000
2025-05-29,MIAX Pearl (P),1391374,200192,352045689.000000,0,0,0.000000,1391374,200192,352045689.000000
2025-05-29,NASDAQ Options Market (Q),1930966,283202,565621298.000000,0,0,0.000000,1930966,283202,565621298.000000
2025-05-29,MIAX Sapphire (S),1571617,239235,412184255.000000,0,0,0.000000,1571617,239235,412184255.000000
2025-05-29,Nasdaq BX Options (T),792293,90241,137365459.000000,0,0,0.000000,792293,90241,137365459.000000
2025-05-29,Members Exchange (U),1672316,240091,418846120.000000,0,0,0.000000,1672316,240091,418846120.000000
2025-05-29,Cboe C2 Options Exchange (W),1367232,166655,284825425.000000,8540,2525,18980998.000000,1375772,169180,303806423.000000
2025-05-29,Nasdaq PHLX (X),5272064,423128,5244363386.000000,37931,16425,181944389.000000,5309995,439553,5426307775.000000
2025-05-29,Cboe BZX Options Exchange (Z),1808438,253748,552828350.000000,1052,505,4235423.000000,1809490,254253,557063773.000000
2025-05-28,NYSE American Options (A),2086569,262660,697855672.000000,0,0,0.000000,2086569,262660,697855672.000000
2025-05-28,BOX Options (B),2738993,312476,1145421530.000000,0,0,0.000000,2738993,312476,1145421530.000000
2025-05-28,Cboe Options Exchange (C),4907573,825118,2081204896.000000,3602341,914127,6576656739.000000,8509914,1739245,8657861635.000000
2025-05-28,MIAX Emerald (D),1005487,191662,304057003.000000,0,0,0.000000,1005487,191662,304057003.000000
2025-05-28,Cboe EDGX Options Exchange (E),2357517,390055,757612661.000000,0,0,0.000000,2357517,390055,757612661.000000
2025-05-28,Nasdaq GEMX (H),1477026,186420,376853380.000000,375,242,12401570.000000,1477401,186662,389254950.000000
2025-05-28,Nasdaq ISE (I),2630357,399972,1062706892.500000,29101,10858,278154788.000000,2659458,410830,1340861680.500000
2025-05-28,Nasdaq MRX (J),1237312,180621,389318332.000000,0,0,0.000000,1237312,180621,389318332.000000
2025-05-28,MIAX Options Exchange (M),3359221,575952,993443142.000000,0,0,0.000000,3359221,575952,993443142.000000
2025-05-28,NYSE Arca Options (N),4256221,573852,1691930719.000000,0,0,0.000000,4256221,573852,1691930719.000000
2025-05-28,MIAX Pearl (P),1206044,183716,328630963.000000,0,0,0.000000,1206044,183716,328630963.000000
2025-05-28,NASDAQ Options Market (Q),1799790,240529,611706480.000000,0,0,0.000000,1799790,240529,611706480.000000
2025-05-28,MIAX Sapphire (S),1324165,209304,409555954.000000,0,0,0.000000,1324165,209304,409555954.000000
2025-05-28,Nasdaq BX Options (T),677981,77373,154908059.000000,0,0,0.000000,677981,77373,154908059.000000
2025-05-28,Members Exchange (U),1472146,209107,399975355.000000,0,0,0.000000,1472146,209107,399975355.000000
2025-05-28,Cboe C2 Options Exchange (W),1371614,153712,280693527.000000,9910,2353,14813680.000000,1381524,156065,295507207.000000
2025-05-28,Nasdaq PHLX (X),3702385,349358,1783231114.000000,31730,13699,176874633.000000,3734115,363057,1960105747.000000
2025-05-28,Cboe BZX Options Exchange (Z),1594186,230065,565537693.000000,1434,519,3734373.000000,1595620,230584,569272066.000000
2025-05-27,NYSE American Options (A),2334523,298795,711692078.000000,0,0,0.000000,2334523,298795,711692078.000000
2025-05-27,BOX Options (B),3257285,364305,1770655689.000000,0,0,0.000000,3257285,364305,1770655689.000000
2025-05-27,Cboe Options Exchange (C),4801630,847952,1947542339.000000,4071272,887619,8691074932.000000,8872902,1735571,10638617271.000000
2025-05-27,MIAX Emerald (D),1126007,217831,375779019.000000,0,0,0.000000,1126007,217831,375779019.000000
2025-05-27,Cboe EDGX Options Exchange (E),2585982,453656,784763501.000000,0,0,0.000000,2585982,453656,784763501.000000
2025-05-27,Nasdaq GEMX (H),1836055,222285,501996680.000000,146,99,4656990.000000,1836201,222384,506653670.000000
2025-05-27,Nasdaq ISE (I),3039895,435638,1281570309.500000,31687,10926,158945148.000000,3071582,446564,1440515457.500000
2025-05-27,Nasdaq MRX (J),1470345,218667,468772102.000000,0,0,0.000000,1470345,218667,468772102.000000
2025-05-27,MIAX Options Exchange (M),4344689,693817,1296271151.000000,0,0,0.000000,4344689,693817,1296271151.000000
2025-05-27,NYSE Arca Options (N),4749072,636676,1986887985.000000,0,0,0.000000,4749072,636676,1986887985.000000
2025-05-27,MIAX Pearl (P),1394598,210757,398509051.000000,0,0,0.000000,1394598,210757,398509051.000000
2025-05-27,NASDAQ Options Market (Q),2062998,292245,739483067.000000,0,0,0.000000,2062998,292245,739483067.000000
2025-05-27,MIAX Sapphire (S),1608555,245471,498497779.000000,0,0,0.000000,1608555,245471,498497779.000000
2025-05-27,Nasdaq BX Options (T),766482,87327,185643076.000000,0,0,0.000000,766482,87327,185643076.000000
2025-05-27,Members Exchange (U),1635165,242278,462508556.000000,0,0,0.000000,1635165,242278,462508556.000000
2025-05-27,Cboe C2 Options Exchange (W),1388928,182160,373558489.000000,15316,3193,125038188.000000,1404244,185353,498596677.000000
2025-05-27,Nasdaq PHLX (X),4161501,424813,1894275325.700000,38069,14674,187738437.000000,4199570,439487,2082013762.700000
2025-05-27,Cboe BZX Options Exchange (Z),1800804,257521,650288561.000000,1015,310,3682248.000000,1801819,257831,653970809.000000
2025-05-23,NYSE American Options (A),2777593,304018,845621150.000000,0,0,0.000000,2777593,304018,845621150.000000
2025-05-23,BOX Options (B),3384320,394160,1283372766.000000,0,0,0.000000,3384320,394160,1283372766.000000
2025-05-23,Cboe Options Exchange (C),5571582,895406,1897529116.000000,4051318,961416,8333459657.000000,9622900,1856822,10230988773.000000
2025-05-23,MIAX Emerald (D),1331024,238520,360166391.000000,0,0,0.000000,1331024,238520,360166391.000000
2025-05-23,Cboe EDGX Options Exchange (E),3243182,474699,818597191.000000,0,0,0.000000,3243182,474699,818597191.000000
2025-05-23,Nasdaq GEMX (H),2057099,250196,464440075.000000,292,136,7742461.000000,2057391,250332,472182536.000000
2025-05-23,Nasdaq ISE (I),3565475,505224,1169353624.000000,24106,11917,141617107.000000,3589581,517141,1310970731.000000
2025-05-23,Nasdaq MRX (J),1572474,208198,418084055.000000,0,0,0.000000,1572474,208198,418084055.000000
2025-05-23,MIAX Options Exchange (M),4925739,782147,1318126857.000000,0,0,0.000000,4925739,782147,1318126857.000000
2025-05-23,NYSE Arca Options (N),5303686,687974,1855281323.000000,0,0,0.000000,5303686,687974,1855281323.000000
2025-05-23,MIAX Pearl (P),1566885,226995,369952745.000000,0,0,0.000000,1566885,226995,369952745.000000
2025-05-23,NASDAQ Options Market (Q),2277213,325291,673211718.000000,0,0,0.000000,2277213,325291,673211718.000000
2025-05-23,MIAX Sapphire (S),1740849,261963,432953327.000000,0,0,0.000000,1740849,261963,432953327.000000
2025-05-23,Nasdaq BX Options (T),840788,92409,155046790.000000,0,0,0.000000,840788,92409,155046790.000000
2025-05-23,Members Exchange (U),1922879,259924,417881484.000000,0,0,0.000000,1922879,259924,417881484.000000
2025-05-23,Cboe C2 Options Exchange (W),1656533,207966,371871784.500000,11985,3157,27857542.000000,1668518,211123,399729326.500000
2025-05-23,Nasdaq PHLX (X),4756523,437202,2179068909.000000,32283,14272,197505313.000000,4788806,451474,2376574222.000000
2025-05-23,Cboe BZX Options Exchange (Z),2030870,276724,570392419.000000,1169,277,3783754.000000,2032039,277001,574176173.000000
2025-05-22,NYSE American Options (A),2670981,288269,883438633.000000,0,0,0.000000,2670981,288269,883438633.000000
2025-05-22,BOX Options (B),3950224,376194,2480942093.000000,0,0,0.000000,3950224,376194,2480942093.000000
2025-05-22,Cboe Options Exchange (C),5624203,837662,3722003776.000000,3995674,954607,9965675953.000000,9619877,1792269,13687679729.000000
2025-05-22,MIAX Emerald (D),1767845,302855,511429084.000000,0,0,0.000000,1767845,302855,511429084.000000
2025-05-22,Cboe EDGX Options Exchange (E),3032916,459531,679025803.000000,0,0,0.000000,3032916,459531,679025803.000000
2025-05-22,Nasdaq GEMX (H),2172498,267783,477281125.000000,104,53,4733555.000000,2172602,267836,482014680.000000
2025-05-22,Nasdaq ISE (I),3037779,431698,1009454038.000000,35043,12467,131882670.000000,3072822,444165,1141336708.000000
2025-05-22,Nasdaq MRX (J),1508312,203013,375743360.000000,0,0,0.000000,1508312,203013,375743360.000000
2025-05-22,MIAX Options Exchange (M),4633629,734333,1180344588.000000,0,0,0.000000,4633629,734333,1180344588.000000
2025-05-22,NYSE Arca Options (N),5210384,652505,1743830683.000000,0,0,0.000000,5210384,652505,1743830683.000000
2025-05-22,MIAX Pearl (P),965564,134851,206518208.000000,0,0,0.000000,965564,134851,206518208.000000
2025-05-22,NASDAQ Options Market (Q),2064801,294196,609277904.000000,0,0,0.000000,2064801,294196,609277904.000000
2025-05-22,MIAX Sapphire (S),1644605,239560,421337449.000000,0,0,0.000000,1644605,239560,421337449.000000
2025-05-22,Nasdaq BX Options (T),815525,90906,145434014.000000,0,0,0.000000,815525,90906,145434014.000000
2025-05-22,Members Exchange (U),1794727,251898,426128134.800000,0,0,0.000000,1794727,251898,426128134.800000
2025-05-22,Cboe C2 Options Exchange (W),1426886,177320,291847807.000000,11051,3118,26310171.000000,1437937,180438,318157978.000000
2025-05-22,Nasdaq PHLX (X),5000818,428035,3952640636.800000,46610,15618,233284637.000000,5047428,443653,4185925273.800000
2025-05-22,Cboe BZX Options Exchange (Z),1943425,266566,564770287.000000,1394,483,6019039.000000,1944819,267049,570789326.000000
2025-05-21,NYSE American Options (A),2700420,308482,648677974.000000,0,0,0.000000,2700420,308482,648677974.000000
2025-05-21,BOX Options (B),3785799,420152,1664998810.000000,0,0,0.000000,3785799,420152,1664998810.000000
2025-05-21,Cboe Options Exchange (C),6032059,978310,1794800461.000000,5111234,1190645,9743966721.000000,11143293,2168955,11538767182.000000
2025-05-21,MIAX Emerald (D),2316427,381015,680998902.000000,0,0,0.000000,2316427,381015,680998902.000000
2025-05-21,Cboe EDGX Options Exchange (E),3297304,528837,809716580.000000,0,0,0.000000,3297304,528837,809716580.000000
2025-05-21,Nasdaq GEMX (H),2484877,315919,599782678.000000,125,91,4618135.000000,2485002,316010,604400813.000000
2025-05-21,Nasdaq ISE (I),3389601,503178,1263489728.000000,41990,15653,194086771.000000,3431591,518831,1457576499.000000
2025-05-21,Nasdaq MRX (J),1711306,239245,437278730.000000,0,0,0.000000,1711306,239245,437278730.000000
2025-05-21,MIAX Options Exchange (M),5721036,850825,1532401883.000000,0,0,0.000000,5721036,850825,1532401883.000000
2025-05-21,NYSE Arca Options (N),5982473,737777,2063376090.000000,0,0,0.000000,5982473,737777,2063376090.000000
2025-05-21,MIAX Pearl (P),1187422,167202,280953745.000000,0,0,0.000000,1187422,167202,280953745.000000
2025-05-21,NASDAQ Options Market (Q),2654217,377202,784968975.000000,0,0,0.000000,2654217,377202,784968975.000000
2025-05-21,MIAX Sapphire (S),1942003,281375,499947565.000000,0,0,0.000000,1942003,281375,499947565.000000
2025-05-21,Nasdaq BX Options (T),918298,108735,193003718.000000,0,0,0.000000,918298,108735,193003718.000000
2025-05-21,Members Exchange (U),2113121,295024,522420548.000000,0,0,0.000000,2113121,295024,522420548.000000
2025-05-21,Cboe C2 Options Exchange (W),1671123,199444,419172360.000000,13773,3518,23300375.000000,1684896,202962,442472735.000000
2025-05-21,Nasdaq PHLX (X),5344252,482781,2010906731.000000,50135,19494,263906813.000000,5394387,502275,2274813544.000000
2025-05-21,Cboe BZX Options Exchange (Z),2372401,330629,742185928.000000,1818,373,5562892.000000,2374219,331002,747748820.000000
2025-05-20,NYSE American Options (A),2154635,255269,677425861.000000,0,0,0.000000,2154635,255269,677425861.000000
2025-05-20,BOX Options (B),2853736,325996,1485332506.000000,0,0,0.000000,2853736,325996,1485332506.000000
2025-05-20,Cboe Options Exchange (C),4184229,701132,1389820522.000000,4099309,935865,11185119809.000000,8283538,1636997,12574940331.000000
2025-05-20,MIAX Emerald (D),1882546,324914,581654256.000000,0,0,0.000000,1882546,324914,581654256.000000
2025-05-20,Cboe EDGX Options Exchange (E),2759772,479375,664871699.000000,0,0,0.000000,2759772,479375,664871699.000000
2025-05-20,Nasdaq GEMX (H),1702637,214723,393268612.000000,150,97,6762580.000000,1702787,214820,400031192.000000
2025-05-20,Nasdaq ISE (I),2658464,401499,1060072165.000000,28668,9843,105637505.000000,2687132,411342,1165709670.000000
2025-05-20,Nasdaq MRX (J),1286628,190666,352632963.000000,0,0,0.000000,1286628,190666,352632963.000000
2025-05-20,MIAX Options Exchange (M),3434428,589073,960440692.000000,0,0,0.000000,3434428,589073,960440692.000000
2025-05-20,NYSE Arca Options (N),4630568,629794,1814647950.000000,0,0,0.000000,4630568,629794,1814647950.000000
2025-05-20,MIAX Pearl (P),749104,108124,164289637.000000,0,0,0.000000,749104,108124,164289637.000000
2025-05-20,NASDAQ Options Market (Q),2037075,308073,648405140.000000,0,0,0.000000,2037075,308073,648405140.000000
2025-05-20,MIAX Sapphire (S),1448425,232315,413554316.000000,0,0,0.000000,1448425,232315,413554316.000000
2025-05-20,Nasdaq BX Options (T),704003,86368,143458851.000000,0,0,0.000000,704003,86368,143458851.000000
2025-05-20,Members Exchange (U),1552096,231740,391264669.000000,0,0,0.000000,1552096,231740,391264669.000000
2025-05-20,Cboe C2 Options Exchange (W),1270051,159486,270829233.500000,7549,2026,10226781.000000,1277600,161512,281056014.500000
2025-05-20,Nasdaq PHLX (X),3761346,405484,1549498035.500000,44472,13979,148803365.000000,3805818,419463,1698301400.500000
2025-05-20,Cboe BZX Options Exchange (Z),1672978,252985,549776248.000000,863,231,3859581.000000,1673841,253216,553635829.000000
2025-05-19,NYSE American Options (A),2325067,253149,1118057123.000000,0,0,0.000000,2325067,253149,1118057123.000000
2025-05-19,BOX Options (B),2811626,330585,1553783747.500000,0,0,0.000000,2811626,330585,1553783747.500000
2025-05-19,Cboe Options Exchange (C),4018596,671356,1430192364.000000,4304351,957287,16883185988.000000,8322947,1628643,18313378352.000000
2025-05-19,MIAX Emerald (D),1849648,334448,577082348.000000,0,0,0.000000,1849648,334448,577082348.000000
2025-05-19,Cboe EDGX Options Exchange (E),2928856,513452,646864916.000000,0,0,0.000000,2928856,513452,646864916.000000
2025-05-19,Nasdaq GEMX (H),1598820,208439,381688817.000000,99,79,3883420.000000,1598919,208518,385572237.000000
2025-05-19,Nasdaq ISE (I),2706859,421212,1058045325.000000,23652,10439,127443002.000000,2730511,431651,1185488327.000000
2025-05-19,Nasdaq MRX (J),1357483,199915,345162025.000000,0,0,0.000000,1357483,199915,345162025.000000
2025-05-19,MIAX Options Exchange (M),3700675,607237,1041494859.000000,0,0,0.000000,3700675,607237,1041494859.000000
2025-05-19,NYSE Arca Options (N),4877561,655011,1959636358.000000,0,0,0.000000,4877561,655011,1959636358.000000
2025-05-19,MIAX Pearl (P),708631,97489,160008219.000000,0,0,0.000000,708631,97489,160008219.000000
2025-05-19,NASDAQ Options Market (Q),1970024,292255,646614745.000000,0,0,0.000000,1970024,292255,646614745.000000
2025-05-19,MIAX Sapphire (S),1504803,224050,430109582.000000,0,0,0.000000,1504803,224050,430109582.000000
2025-05-19,Nasdaq BX Options (T),763009,87947,153597839.000000,0,0,0.000000,763009,87947,153597839.000000
2025-05-19,Members Exchange (U),1527594,220238,407227721.000000,0,0,0.000000,1527594,220238,407227721.000000
2025-05-19,Cboe C2 Options Exchange (W),1286554,167226,337556663.000000,9464,2104,15738688.000000,1296018,169330,353295351.000000
2025-05-19,Nasdaq PHLX (X),3810974,416285,1949671532.000000,33365,14196,172144667.000000,3844339,430481,2121816199.000000
2025-05-19,Cboe BZX Options Exchange (Z),1695992,244521,600883534.000000,942,262,3880226.000000,1696934,244783,604763760.000000
2025-05-16,NYSE American Options (A),2835371,302452,878830376.000000,0,0,0.000000,2835371,302452,878830376.000000
2025-05-16,BOX Options (B),3367734,384357,1577788945.000000,0,0,0.000000,3367734,384357,1577788945.000000
2025-05-16,Cboe Options Exchange (C),5373179,853033,2072428430.000000,4229296,904132,16011376631.000000,9602475,1757165,18083805061.000000
2025-05-16,MIAX Emerald (D),2569672,444741,746075687.000000,0,0,0.000000,2569672,444741,746075687.000000
2025-05-16,Cboe EDGX Options Exchange (E),4557855,616501,1080401808.000000,0,0,0.000000,4557855,616501,1080401808.000000
2025-05-16,Nasdaq GEMX (H),2022444,242172,468807166.000000,2198,779,121553218.000000,2024642,242951,590360384.000000
2025-05-16,Nasdaq ISE (I),4207836,577052,1822512840.500000,39033,12679,246622887.000000,4246869,589731,2069135727.500000
2025-05-16,Nasdaq MRX (J),1836927,251122,473723508.000000,0,0,0.000000,1836927,251122,473723508.000000
2025-05-16,MIAX Options Exchange (M),4627962,753586,1315355268.000000,0,0,0.000000,4627962,753586,1315355268.000000
2025-05-16,NYSE Arca Options (N),6386021,876313,2937789283.000000,0,0,0.000000,6386021,876313,2937789283.000000
2025-05-16,MIAX Pearl (P),858872,112244,157246415.000000,0,0,0.000000,858872,112244,157246415.000000
2025-05-16,NASDAQ Options Market (Q),2593328,363149,754530237.000000,0,0,0.000000,2593328,363149,754530237.000000
2025-05-16,MIAX Sapphire (S),1931840,262886,533162440.000000,0,0,0.000000,1931840,262886,533162440.000000
2025-05-16,Nasdaq BX Options (T),993390,110651,159036060.000000,0,0,0.000000,993390,110651,159036060.000000
2025-05-16,Members Exchange (U),2059356,282168,490477091.000000,0,0,0.000000,2059356,282168,490477091.000000
2025-05-16,Cboe C2 Options Exchange (W),1990190,239812,502023813.000000,12197,2783,28472537.000000,2002387,242595,530496350.000000
2025-05-16,Nasdaq PHLX (X),4994825,486445,2370682493.250000,14867,4948,279542341.000000,5009692,491393,2650224834.250000
2025-05-16,Cboe BZX Options Exchange (Z),2247546,317128,698491909.500000,3732,588,22323655.000000,2251278,317716,720815564.500000
2025-05-15,NYSE American Options (A),2555692,277673,897908003.000000,0,0,0.000000,2555692,277673,897908003.000000
2025-05-15,BOX Options (B),5174128,358321,6624728599.000000,0,0,0.000000,5174128,358321,6624728599.000000
2025-05-15,Cboe Options Exchange (C),4709916,758194,2201028917.000000,4831263,971974,13746248608.000000,9541179,1730168,15947277525.000000
2025-05-15,MIAX Emerald (D),2430677,432972,757912536.000000,0,0,0.000000,2430677,432972,757912536.000000
2025-05-15,Cboe EDGX Options Exchange (E),3793062,559623,1096687251.000000,0,0,0.000000,3793062,559623,1096687251.000000
2025-05-15,Nasdaq GEMX (H),2010821,242170,484813965.000000,1997,1118,430851058.000000,2012818,243288,915665023.000000
2025-05-15,Nasdaq ISE (I),3499759,490935,2253570410.500000,44645,13617,763014755.000000,3544404,504552,3016585165.500000
2025-05-15,Nasdaq MRX (J),1706959,230859,494621051.000000,0,0,0.000000,1706959,230859,494621051.000000
2025-05-15,MIAX Options Exchange (M),4319685,697653,1421809106.000000,0,0,0.000000,4319685,697653,1421809106.000000
2025-05-15,NYSE Arca Options (N),6245807,838068,2751856218.000000,0,0,0.000000,6245807,838068,2751856218.000000
2025-05-15,MIAX Pearl (P),830749,105278,178676698.000000,0,0,0.000000,830749,105278,178676698.000000
2025-05-15,NASDAQ Options Market (Q),2481133,356155,840542488.000000,0,0,0.000000,2481133,356155,840542488.000000
2025-05-15,MIAX Sapphire (S),1796075,238604,512678623.000000,0,0,0.000000,1796075,238604,512678623.000000
2025-05-15,Nasdaq BX Options (T),886143,101776,174229713.000000,0,0,0.000000,886143,101776,174229713.000000
2025-05-15,Members Exchange (U),1918872,266913,502028124.000000,0,0,0.000000,1918872,266913,502028124.000000
2025-05-15,Cboe C2 Options Exchange (W),1724262,205153,427767850.000000,8880,2369,27224513.000000,1733142,207522,454992363.000000
2025-05-15,Nasdaq PHLX (X),5967310,460841,5064315302.000000,79784,17044,807969138.000000,6047094,477885,5872284440.000000
2025-05-15,Cboe BZX Options Exchange (Z),2093530,292117,755699808.000000,2184,461,15929942.000000,2095714,292578,771629750.000000
2025-05-14,NYSE American Options (A),2878046,287429,902806498.000000,0,0,0.000000,2878046,287429,902806498.000000
2025-05-14,BOX Options (B),4356581,366481,4195818971.000000,0,0,0.000000,4356581,366481,4195818971.000000
2025-05-14,Cboe Options Exchange (C),4978322,818020,2280464406.000000,4357547,926524,12002401736.000000,9335869,1744544,14282866142.000000
2025-05-14,MIAX Emerald (D),2464921,424583,821733640.000000,0,0,0.000000,2464921,424583,821733640.000000
2025-05-14,Cboe EDGX Options Exchange (E),3940930,582834,1125561199.000000,0,0,0.000000,3940930,582834,1125561199.000000
2025-05-14,Nasdaq GEMX (H),2124227,254646,527761738.000000,1092,648,36586955.000000,2125319,255294,564348693.000000
2025-05-14,Nasdaq ISE (I),3489510,529539,1789920872.000000,24660,10676,381737341.000000,3514170,540215,2171658213.000000
2025-05-14,Nasdaq MRX (J),1618637,232253,512259294.000000,0,0,0.000000,1618637,232253,512259294.000000
2025-05-14,MIAX Options Exchange (M),4267981,723697,1450919372.000000,0,0,0.000000,4267981,723697,1450919372.000000
2025-05-14,NYSE Arca Options (N),6789810,913118,2983205941.000000,0,0,0.000000,6789810,913118,2983205941.000000
2025-05-14,MIAX Pearl (P),856835,112042,196992014.000000,0,0,0.000000,856835,112042,196992014.000000
2025-05-14,NASDAQ Options Market (Q),2719267,381778,977552257.000000,0,0,0.000000,2719267,381778,977552257.000000
2025-05-14,MIAX Sapphire (S),1808245,252098,626174531.000000,0,0,0.000000,1808245,252098,626174531.000000
2025-05-14,Nasdaq BX Options (T),887767,105380,220085924.000000,0,0,0.000000,887767,105380,220085924.000000
2025-05-14,Members Exchange (U),1996038,273010,551027442.000000,0,0,0.000000,1996038,273010,551027442.000000
2025-05-14,Cboe C2 Options Exchange (W),1640573,211123,504628855.000000,7781,2350,16618072.000000,1648354,213473,521246927.000000
2025-05-14,Nasdaq PHLX (X),5908522,478981,4933691272.000000,38002,14448,412167303.000000,5946524,493429,5345858575.000000
2025-05-14,Cboe BZX Options Exchange (Z),2311521,319400,860621824.500000,1917,654,6018321.000000,2313438,320054,866640145.500000
2025-05-13,NYSE American Options (A),3792830,314807,1564372047.000000,0,0,0.000000,3792830,314807,1564372047.000000
2025-05-13,BOX Options (B),4124934,401777,2089630092.000000,0,0,0.000000,4124934,401777,2089630092.000000
2025-05-13,Cboe Options Exchange (C),6157958,919318,3330859464.000000,5334498,982314,13067747268.000000,11492456,1901632,16398606732.000000
2025-05-13,MIAX Emerald (D),2428234,418905,874103899.000000,0,0,0.000000,2428234,418905,874103899.000000
2025-05-13,Cboe EDGX Options Exchange (E),4756474,651303,1595839264.000000,0,0,0.000000,4756474,651303,1595839264.000000
2025-05-13,Nasdaq GEMX (H),2378286,276158,649712361.000000,689,228,8540446.000000,2378975,276386,658252807.000000
2025-05-13,Nasdaq ISE (I),4206205,604238,2029190552.500000,37995,13611,389426395.000000,4244200,617849,2418616947.500000
2025-05-13,Nasdaq MRX (J),1945553,262169,658372050.000000,0,0,0.000000,1945553,262169,658372050.000000
2025-05-13,MIAX Options Exchange (M),5057889,806344,1875099033.000000,0,0,0.000000,5057889,806344,1875099033.000000
2025-05-13,NYSE Arca Options (N),7668517,970568,3601912357.000000,0,0,0.000000,7668517,970568,3601912357.000000
2025-05-13,MIAX Pearl (P),1343473,190135,356579899.000000,0,0,0.000000,1343473,190135,356579899.000000
2025-05-13,NASDAQ Options Market (Q),2932482,410893,1082488150.000000,0,0,0.000000,2932482,410893,1082488150.000000
2025-05-13,MIAX Sapphire (S),2070104,281850,686237195.000000,0,0,0.000000,2070104,281850,686237195.000000
2025-05-13,Nasdaq BX Options (T),1006763,117063,258153812.000000,0,0,0.000000,1006763,117063,258153812.000000
2025-05-13,Members Exchange (U),2179791,295890,638845919.000000,0,0,0.000000,2179791,295890,638845919.000000
2025-05-13,Cboe C2 Options Exchange (W),1866017,243152,625591290.000000,14987,2540,25429983.000000,1881004,245692,651021273.000000
2025-05-13,Nasdaq PHLX (X),5457513,505019,2157253336.000000,48096,16515,402025027.000000,5505609,521534,2559278363.000000
2025-05-13,Cboe BZX Options Exchange (Z),2503748,348539,963216273.000000,1484,566,5578242.000000,2505232,349105,968794515.000000
2025-05-12,NYSE American Options (A),2790271,308442,934835032.000000,0,0,0.000000,2790271,308442,934835032.000000
2025-05-12,BOX Options (B),4198077,483003,1810699844.000000,0,0,0.000000,4198077,483003,1810699844.000000
2025-05-12,Cboe Options Exchange (C),5711538,896492,2345795661.000000,5868734,979515,14040007503.000000,11580272,1876007,16385803164.000000
2025-05-12,MIAX Emerald (D),2319799,397892,797984783.000000,0,0,0.000000,2319799,397892,797984783.000000
2025-05-12,Cboe EDGX Options Exchange (E),3992437,633852,1170380301.000000,0,0,0.000000,3992437,633852,1170380301.000000
2025-05-12,Nasdaq GEMX (H),2413552,269189,620459309.000000,481,269,13464385.000000,2414033,269458,633923694.000000
2025-05-12,Nasdaq ISE (I),4266337,619648,1923099224.000000,26985,11480,265197981.000000,4293322,631128,2188297205.000000
2025-05-12,Nasdaq MRX (J),1793971,237827,546397858.000000,0,0,0.000000,1793971,237827,546397858.000000
2025-05-12,MIAX Options Exchange (M),4855017,754575,1634606877.000000,0,0,0.000000,4855017,754575,1634606877.000000
2025-05-12,NYSE Arca Options (N),7497633,925031,3015136015.000000,0,0,0.000000,7497633,925031,3015136015.000000
2025-05-12,MIAX Pearl (P),1213047,164007,321403544.000000,0,0,0.000000,1213047,164007,321403544.000000
2025-05-12,NASDAQ Options Market (Q),2834230,394096,997398641.000000,0,0,0.000000,2834230,394096,997398641.000000
2025-05-12,MIAX Sapphire (S),2018111,281632,644132257.000000,0,0,0.000000,2018111,281632,644132257.000000
2025-05-12,Nasdaq BX Options (T),950407,107321,244370310.000000,0,0,0.000000,950407,107321,244370310.000000
2025-05-12,Members Exchange (U),2054571,283752,569803225.000000,0,0,0.000000,2054571,283752,569803225.000000
2025-05-12,Cboe C2 Options Exchange (W),1900221,237474,540883969.000000,12390,3612,24062063.000000,1912611,241086,564946032.000000
2025-05-12,Nasdaq PHLX (X),5508466,495435,2182227992.000000,37353,14069,379913819.000000,5545819,509504,2562141811.000000
2025-05-12,Cboe BZX Options Exchange (Z),2391313,321804,857086081.100000,2356,732,6522588.000000,2393669,322536,863608669.100000
2025-05-09,NYSE American Options (A),2609484,254920,727661791.000000,0,0,0.000000,2609484,254920,727661791.000000
2025-05-09,BOX Options (B),3769119,423426,1275028120.000000,0,0,0.000000,3769119,423426,1275028120.000000
2025-05-09,Cboe Options Exchange (C),5037527,731154,1702859274.000000,3899206,935420,6992159360.000000,8936733,1666574,8695018634.000000
2025-05-09,MIAX Emerald (D),1782472,306464,461213587.000000,0,0,0.000000,1782472,306464,461213587.000000
2025-05-09,Cboe EDGX Options Exchange (E),4195860,593766,787956966.000000,0,0,0.000000,4195860,593766,787956966.000000
2025-05-09,Nasdaq GEMX (H),2132222,265500,426555379.500000,485,330,5910205.000000,2132707,265830,432465584.500000
2025-05-09,Nasdaq ISE (I),3731177,544867,1298213930.500000,25692,10383,112198923.000000,3756869,555250,1410412853.500000
2025-05-09,Nasdaq MRX (J),1639817,219272,365577821.000000,0,0,0.000000,1639817,219272,365577821.000000
2025-05-09,MIAX Options Exchange (M),4064526,651155,1017003268.000000,0,0,0.000000,4064526,651155,1017003268.000000
2025-05-09,NYSE Arca Options (N),6400733,875071,2066234124.000000,0,0,0.000000,6400733,875071,2066234124.000000
2025-05-09,MIAX Pearl (P),1404451,203457,287671633.000000,0,0,0.000000,1404451,203457,287671633.000000
2025-05-09,NASDAQ Options Market (Q),2436779,351836,656718640.000000,0,0,0.000000,2436779,351836,656718640.000000
2025-05-09,MIAX Sapphire (S),1802703,249867,419132680.000000,0,0,0.000000,1802703,249867,419132680.000000
2025-05-09,Nasdaq BX Options (T),914169,102658,183452708.000000,0,0,0.000000,914169,102658,183452708.000000
2025-05-09,Members Exchange (U),1966618,265518,423261509.000000,0,0,0.000000,1966618,265518,423261509.000000
2025-05-09,Cboe C2 Options Exchange (W),1801714,219698,349292917.000000,15316,2952,19624990.000000,1817030,222650,368917907.000000
2025-05-09,Nasdaq PHLX (X),5114183,436703,1590552480.000000,32889,12388,175789631.000000,5147072,449091,1766342111.000000
2025-05-09,Cboe BZX Options Exchange (Z),2129952,286882,584942568.000000,1888,613,4462824.000000,2131840,287495,589405392.000000
2025-05-08,NYSE American Options (A),2604389,247886,932904949.000000,0,0,0.000000,2604389,247886,932904949.000000
2025-05-08,BOX Options (B),4169179,423426,1845673175.500000,0,0,0.000000,4169179,423426,1845673175.500000
2025-05-08,Cboe Options Exchange (C),6616443,859702,2872756072.000000,4722366,991435,10148906551.000000,11338809,1851137,13021662623.000000
2025-05-08,MIAX Emerald (D),2292987,401474,700746949.000000,0,0,0.000000,2292987,401474,700746949.000000
2025-05-08,Cboe EDGX Options Exchange (E),3924425,606944,842794698.500000,0,0,0.000000,3924425,606944,842794698.500000
2025-05-08,Nasdaq GEMX (H),2394242,294675,534997518.000000,322,145,7400262.000000,2394564,294820,542397780.000000
2025-05-08,Nasdaq ISE (I),3946839,574984,1484636789.000000,26823,11311,178418539.000000,3973662,586295,1663055328.000000
2025-05-08,Nasdaq MRX (J),1743834,233208,407196505.000000,0,0,0.000000,1743834,233208,407196505.000000
2025-05-08,MIAX Options Exchange (M),4329852,716590,1249931237.000000,0,0,0.000000,4329852,716590,1249931237.000000
2025-05-08,NYSE Arca Options (N),7048059,917499,2293676844.000000,0,0,0.000000,7048059,917499,2293676844.000000
2025-05-08,MIAX Pearl (P),1225122,172751,270969211.000000,0,0,0.000000,1225122,172751,270969211.000000
2025-05-08,NASDAQ Options Market (Q),2529013,363859,714142049.000000,0,0,0.000000,2529013,363859,714142049.000000
2025-05-08,MIAX Sapphire (S),1872010,258345,523781398.000000,0,0,0.000000,1872010,258345,523781398.000000
2025-05-08,Nasdaq BX Options (T),914512,103487,179830711.000000,0,0,0.000000,914512,103487,179830711.000000
2025-05-08,Members Exchange (U),2084339,277177,479893716.000000,0,0,0.000000,2084339,277177,479893716.000000
2025-05-08,Cboe C2 Options Exchange (W),1690044,219562,421169019.000000,11460,3069,19417388.000000,1701504,222631,440586407.000000
2025-05-08,Nasdaq PHLX (X),5551899,484323,2532039343.000000,33888,14124,243060226.000000,5585787,498447,2775099569.000000
2025-05-08,Cboe BZX Options Exchange (Z),2247216,309220,687468021.000000,2321,748,7848695.000000,2249537,309968,695316716.000000
2025-05-07,NYSE American Options (A),2353332,219807,976576267.000000,0,0,0.000000,2353332,219807,976576267.000000
2025-05-07,BOX Options (B),2907837,336705,1195326008.000000,0,0,0.000000,2907837,336705,1195326008.000000
2025-05-07,Cboe Options Exchange (C),4113595,657437,1284289821.000000,3417498,804335,8672122962.000000,7531093,1461772,9956412783.000000
2025-05-07,MIAX Emerald (D),1646965,291299,472953667.000000,0,0,0.000000,1646965,291299,472953667.000000
2025-05-07,Cboe EDGX Options Exchange (E),2795254,503333,590641332.000000,0,0,0.000000,2795254,503333,590641332.000000
2025-05-07,Nasdaq GEMX (H),1935293,257816,452115647.000000,326,268,12037150.000000,1935619,258084,464152797.000000
2025-05-07,Nasdaq ISE (I),2884286,445843,876027553.000000,26269,10213,117920183.000000,2910555,456056,993947736.000000
2025-05-07,Nasdaq MRX (J),1287221,183466,306963623.000000,0,0,0.000000,1287221,183466,306963623.000000
2025-05-07,MIAX Options Exchange (M),3232105,563730,863229753.000000,0,0,0.000000,3232105,563730,863229753.000000
2025-05-07,NYSE Arca Options (N),5569220,789619,1824686031.000000,0,0,0.000000,5569220,789619,1824686031.000000
2025-05-07,MIAX Pearl (P),1192768,179251,273191249.000000,0,0,0.000000,1192768,179251,273191249.000000
2025-05-07,NASDAQ Options Market (Q),2049747,298480,599278208.000000,0,0,0.000000,2049747,298480,599278208.000000
2025-05-07,MIAX Sapphire (S),1389464,203675,332977392.000000,0,0,0.000000,1389464,203675,332977392.000000
2025-05-07,Nasdaq BX Options (T),714316,89219,121810875.000000,0,0,0.000000,714316,89219,121810875.000000
2025-05-07,Members Exchange (U),1660398,225788,389451027.000000,0,0,0.000000,1660398,225788,389451027.000000
2025-05-07,Cboe C2 Options Exchange (W),1255041,170949,314122604.000000,7916,2451,14966421.000000,1262957,173400,329089025.000000
2025-05-07,Nasdaq PHLX (X),3977659,380608,1157439412.700000,27467,11649,156318711.000000,4005126,392257,1313758123.700000
2025-05-07,Cboe BZX Options Exchange (Z),1791209,254029,508912738.000000,1581,613,3377045.000000,1792790,254642,512289783.000000
2025-05-06,NYSE American Options (A),2229223,214957,878499222.000000,0,0,0.000000,2229223,214957,878499222.000000
2025-05-06,BOX Options (B),2852877,317722,814996068.000000,0,0,0.000000,2852877,317722,814996068.000000
2025-05-06,Cboe Options Exchange (C),3930188,599446,1411856469.000000,3730686,972922,10022616821.000000,7660874,1572368,11434473290.000000
2025-05-06,MIAX Emerald (D),1490473,270638,454756519.000000,0,0,0.000000,1490473,270638,454756519.000000
2025-05-06,Cboe EDGX Options Exchange (E),2973956,493769,684457200.000000,0,0,0.000000,2973956,493769,684457200.000000
2025-05-06,Nasdaq GEMX (H),1990306,230324,410951329.000000,312,201,13600920.000000,1990618,230525,424552249.000000
2025-05-06,Nasdaq ISE (I),2619369,414578,858514757.000000,26270,11394,149997611.000000,2645639,425972,1008512368.000000
2025-05-06,Nasdaq MRX (J),1274739,189209,310405829.000000,0,0,0.000000,1274739,189209,310405829.000000
2025-05-06,MIAX Options Exchange (M),3348564,524559,884592345.000000,0,0,0.000000,3348564,524559,884592345.000000
2025-05-06,NYSE Arca Options (N),5037231,717652,1851985989.000000,0,0,0.000000,5037231,717652,1851985989.000000
2025-05-06,MIAX Pearl (P),1049709,158869,248376959.000000,0,0,0.000000,1049709,158869,248376959.000000
2025-05-06,NASDAQ Options Market (Q),1923082,284504,556522170.000000,0,0,0.000000,1923082,284504,556522170.000000
2025-05-06,MIAX Sapphire (S),1325751,202263,308360722.000000,0,0,0.000000,1325751,202263,308360722.000000
2025-05-06,Nasdaq BX Options (T),679443,83227,124451216.000000,0,0,0.000000,679443,83227,124451216.000000
2025-05-06,Members Exchange (U),1502146,204803,346976549.000000,0,0,0.000000,1502146,204803,346976549.000000
2025-05-06,Cboe C2 Options Exchange (W),1242186,160219,319633477.000000,8705,2745,22119229.000000,1250891,162964,341752706.000000
2025-05-06,Nasdaq PHLX (X),3841608,351891,1101874998.000000,31625,12798,219879229.000000,3873233,364689,1321754227.000000
2025-05-06,Cboe BZX Options Exchange (Z),1590663,227146,475908365.500000,2318,696,8579855.000000,1592981,227842,484488220.500000
2025-05-05,NYSE American Options (A),2188513,205516,1231400435.000000,0,0,0.000000,2188513,205516,1231400435.000000
2025-05-05,BOX Options (B),2487653,318882,823553410.000000,0,0,0.000000,2487653,318882,823553410.000000
2025-05-05,Cboe Options Exchange (C),3846230,602850,1436461114.000000,3486316,824092,9294096226.000000,7332546,1426942,10730557340.000000
2025-05-05,MIAX Emerald (D),1368175,254397,456111971.000000,0,0,0.000000,1368175,254397,456111971.000000
2025-05-05,Cboe EDGX Options Exchange (E),2776168,506294,695617923.000000,0,0,0.000000,2776168,506294,695617923.000000
2025-05-05,Nasdaq GEMX (H),1719881,222042,377510539.000000,226,131,8604340.000000,1720107,222173,386114879.000000
2025-05-05,Nasdaq ISE (I),2550027,411403,940948192.000000,22028,11017,161731390.000000,2572055,422420,1102679582.000000
2025-05-05,Nasdaq MRX (J),1187565,185955,303568709.000000,0,0,0.000000,1187565,185955,303568709.000000
2025-05-05,MIAX Options Exchange (M),3324115,515017,914805374.000000,0,0,0.000000,3324115,515017,914805374.000000
2025-05-05,NYSE Arca Options (N),4778486,715437,1984733584.000000,0,0,0.000000,4778486,715437,1984733584.000000
2025-05-05,MIAX Pearl (P),948081,150147,239184415.000000,0,0,0.000000,948081,150147,239184415.000000
2025-05-05,NASDAQ Options Market (Q),1736321,267662,530356194.000000,0,0,0.000000,1736321,267662,530356194.000000
2025-05-05,MIAX Sapphire (S),1296960,199548,309794654.000000,0,0,0.000000,1296960,199548,309794654.000000
2025-05-05,Nasdaq BX Options (T),645500,80817,124553470.000000,0,0,0.000000,645500,80817,124553470.000000
2025-05-05,Members Exchange (U),1357808,189124,329777020.000000,0,0,0.000000,1357808,189124,329777020.000000
2025-05-05,Cboe C2 Options Exchange (W),1226410,160057,283475075.000000,9212,2472,17090345.000000,1235622,162529,300565420.000000
2025-05-05,Nasdaq PHLX (X),3365218,353122,1150583388.000000,29806,12261,206320351.000000,3395024,365383,1356903739.000000
2025-05-05,Cboe BZX Options Exchange (Z),1551317,215934,511993992.000000,1528,412,5643249.000000,1552845,216346,517637241.000000
2025-05-02,NYSE American Options (A),2695463,230547,851631966.000000,0,0,0.000000,2695463,230547,851631966.000000
2025-05-02,BOX Options (B),3651563,442759,1184354072.000000,0,0,0.000000,3651563,442759,1184354072.000000
2025-05-02,Cboe Options Exchange (C),5274190,857986,1950678111.000000,4346293,992279,11720790471.000000,9620483,1850265,13671468582.000000
2025-05-02,MIAX Emerald (D),2378483,407809,776968637.000000,0,0,0.000000,2378483,407809,776968637.000000
2025-05-02,Cboe EDGX Options Exchange (E),5546833,761276,1174670905.000000,0,0,0.000000,5546833,761276,1174670905.000000
2025-05-02,Nasdaq GEMX (H),2539672,308903,546771459.000000,495,161,10806915.000000,2540167,309064,557578374.000000
2025-05-02,Nasdaq ISE (I),4123679,630114,1544252032.000000,24115,11349,457278065.000000,4147794,641463,2001530097.000000
2025-05-02,Nasdaq MRX (J),1823683,245623,485476715.000000,0,0,0.000000,1823683,245623,485476715.000000
2025-05-02,MIAX Options Exchange (M),4480218,729059,1287260159.000000,0,0,0.000000,4480218,729059,1287260159.000000
2025-05-02,NYSE Arca Options (N),7487875,1030258,2413216556.000000,0,0,0.000000,7487875,1030258,2413216556.000000
2025-05-02,MIAX Pearl (P),1275087,174894,263950796.000000,0,0,0.000000,1275087,174894,263950796.000000
2025-05-02,NASDAQ Options Market (Q),2695694,393856,762635151.000000,0,0,0.000000,2695694,393856,762635151.000000
2025-05-02,MIAX Sapphire (S),2000032,287115,503688214.000000,0,0,0.000000,2000032,287115,503688214.000000
2025-05-02,Nasdaq BX Options (T),986245,116330,189502979.000000,0,0,0.000000,986245,116330,189502979.000000
2025-05-02,Members Exchange (U),2058008,269101,462522956.000000,0,0,0.000000,2058008,269101,462522956.000000
2025-05-02,Cboe C2 Options Exchange (W),1830025,226888,424851372.000000,14594,3498,39396309.000000,1844619,230386,464247681.000000
2025-05-02,Nasdaq PHLX (X),5451453,485638,1810290233.000000,29716,13451,378560790.000000,5481169,499089,2188851023.000000
2025-05-02,Cboe BZX Options Exchange (Z),2376159,317047,685636848.000000,1637,685,4720141.000000,2377796,317732,690356989.000000
2025-05-01,NYSE American Options (A),3001855,252825,947788480.000000,0,0,0.000000,3001855,252825,947788480.000000
2025-05-01,BOX Options (B),3671063,370904,2760017453.100000,0,0,0.000000,3671063,370904,2760017453.100000
2025-05-01,Cboe Options Exchange (C),4850729,800283,2077832253.000000,4031757,957375,12085518290.000000,8882486,1757658,14163350543.000000
2025-05-01,MIAX Emerald (D),2005388,352911,774737651.000000,0,0,0.000000,2005388,352911,774737651.000000
2025-05-01,Cboe EDGX Options Exchange (E),3507605,620194,1028285932.000000,0,0,0.000000,3507605,620194,1028285932.000000
2025-05-01,Nasdaq GEMX (H),2202381,288033,586802774.000000,457,174,7155670.000000,2202838,288207,593958444.000000
2025-05-01,Nasdaq ISE (I),3381349,530510,1543586951.000000,27670,11899,162069458.000000,3409019,542409,1705656409.000000
2025-05-01,Nasdaq MRX (J),1525076,222861,461745839.000000,0,0,0.000000,1525076,222861,461745839.000000
2025-05-01,MIAX Options Exchange (M),3791310,641001,1329194269.000000,0,0,0.000000,3791310,641001,1329194269.000000
2025-05-01,NYSE Arca Options (N),6374197,937182,2516530556.000000,0,0,0.000000,6374197,937182,2516530556.000000
2025-05-01,MIAX Pearl (P),1142585,162729,306074510.000000,0,0,0.000000,1142585,162729,306074510.000000
2025-05-01,NASDAQ Options Market (Q),2331806,344294,797668835.000000,0,0,0.000000,2331806,344294,797668835.000000
2025-05-01,MIAX Sapphire (S),1618444,242504,504122715.000000,0,0,0.000000,1618444,242504,504122715.000000
2025-05-01,Nasdaq BX Options (T),823519,99003,169456503.000000,0,0,0.000000,823519,99003,169456503.000000
2025-05-01,Members Exchange (U),1764150,237937,481010815.000000,0,0,0.000000,1764150,237937,481010815.000000
2025-05-01,Cboe C2 Options Exchange (W),1569773,200549,431481632.000000,11027,2561,19253948.000000,1580800,203110,450735580.000000
2025-05-01,Nasdaq PHLX (X),4580883,435112,2468262621.700000,32991,13732,257311528.000000,4613874,448844,2725574149.700000
2025-05-01,Cboe BZX Options Exchange (Z),1931242,269987,658393929.000000,1455,572,5113969.000000,1932697,270559,663507898.000000
2025-04-30,NYSE American Options (A),2168615,241159,528780692.000000,0,0,0.000000,2168615,241159,528780692.000000
2025-04-30,BOX Options (B),3375123,384686,963352363.000000,0,0,0.000000,3375123,384686,963352363.000000
2025-04-30,Cboe Options Exchange (C),4188442,692590,1549670803.000000,4338660,1025220,12746728695.000000,8527102,1717810,14296399498.000000
2025-04-30,MIAX Emerald (D),1882465,303146,618362526.000000,0,0,0.000000,1882465,303146,618362526.000000
2025-04-30,Cboe EDGX Options Exchange (E),3037163,529520,718338733.000000,0,0,0.000000,3037163,529520,718338733.000000
2025-04-30,Nasdaq GEMX (H),2581188,367769,663694805.000000,281,177,8435483.000000,2581469,367946,672130288.000000
2025-04-30,Nasdaq ISE (I),2888787,446310,1061069812.000000,25527,11991,199771316.000000,2914314,458301,1260841128.000000
2025-04-30,Nasdaq MRX (J),1456346,204547,375077419.000000,0,0,0.000000,1456346,204547,375077419.000000
2025-04-30,MIAX Options Exchange (M),3485044,526306,1058195080.000000,0,0,0.000000,3485044,526306,1058195080.000000
2025-04-30,NYSE Arca Options (N),5264594,667389,2020221262.000000,0,0,0.000000,5264594,667389,2020221262.000000
2025-04-30,MIAX Pearl (P),994083,132951,241221368.000000,0,0,0.000000,994083,132951,241221368.000000
2025-04-30,NASDAQ Options Market (Q),2129456,307014,708586858.000000,0,0,0.000000,2129456,307014,708586858.000000
2025-04-30,MIAX Sapphire (S),1512350,216521,433015087.000000,0,0,0.000000,1512350,216521,433015087.000000
2025-04-30,Nasdaq BX Options (T),745420,83608,149932767.000000,0,0,0.000000,745420,83608,149932767.000000
2025-04-30,Members Exchange (U),1617582,206580,393004969.000000,0,0,0.000000,1617582,206580,393004969.000000
2025-04-30,Cboe C2 Options Exchange (W),1497481,168697,359394787.000000,10004,2566,25564236.000000,1507485,171263,384959023.000000
2025-04-30,Nasdaq PHLX (X),4632066,382657,1746529684.000000,28569,14562,232732710.000000,4660635,397219,1979262394.000000
2025-04-30,Cboe BZX Options Exchange (Z),1706247,227171,542592652.000000,2296,494,12285246.000000,1708543,227665,554877898.000000
2025-04-29,NYSE American Options (A),1867451,205397,528875318.000000,0,0,0.000000,1867451,205397,528875318.000000
2025-04-29,BOX Options (B),2842599,358607,962844376.000000,0,0,0.000000,2842599,358607,962844376.000000
2025-04-29,Cboe Options Exchange (C),3730405,602745,1442606794.000000,4276783,965623,12542476948.000000,8007188,1568368,13985083742.000000
2025-04-29,MIAX Emerald (D),1594001,262733,495804198.000000,0,0,0.000000,1594001,262733,495804198.000000
2025-04-29,Cboe EDGX Options Exchange (E),2753308,499134,656013810.000000,0,0,0.000000,2753308,499134,656013810.000000
2025-04-29,Nasdaq GEMX (H),2257316,302962,517520658.000000,235,128,12628250.000000,2257551,303090,530148908.000000
2025-04-29,Nasdaq ISE (I),2527573,389331,955763944.500000,22201,10988,234704349.000000,2549774,400319,1190468293.500000
2025-04-29,Nasdaq MRX (J),1333936,183796,335239908.000000,0,0,0.000000,1333936,183796,335239908.000000
2025-04-29,MIAX Options Exchange (M),3066575,467888,887431272.000000,0,0,0.000000,3066575,467888,887431272.000000
2025-04-29,NYSE Arca Options (N),4533290,590983,1886919372.000000,0,0,0.000000,4533290,590983,1886919372.000000
2025-04-29,MIAX Pearl (P),921751,118916,205226859.000000,0,0,0.000000,921751,118916,205226859.000000
2025-04-29,NASDAQ Options Market (Q),1758670,257411,572766767.000000,0,0,0.000000,1758670,257411,572766767.000000
2025-04-29,MIAX Sapphire (S),1338839,197327,338800713.000000,0,0,0.000000,1338839,197327,338800713.000000
2025-04-29,Nasdaq BX Options (T),687420,76923,116287351.000000,0,0,0.000000,687420,76923,116287351.000000
2025-04-29,Members Exchange (U),1403838,179205,333023279.000000,0,0,0.000000,1403838,179205,333023279.000000
2025-04-29,Cboe C2 Options Exchange (W),1187316,150554,303672873.000000,8247,2693,19441497.000000,1195563,153247,323114370.000000
2025-04-29,Nasdaq PHLX (X),3709641,343791,1201384978.000000,26242,13983,255331392.000000,3735883,357774,1456716370.000000
2025-04-29,Cboe BZX Options Exchange (Z),1500576,196925,470214670.000000,1529,406,8518203.000000,1502105,197331,478732873.000000
2025-04-28,NYSE American Options (A),2684639,227465,1280888690.000000,0,0,0.000000,2684639,227465,1280888690.000000
2025-04-28,BOX Options (B),3039845,401127,811625606.000000,0,0,0.000000,3039845,401127,811625606.000000
2025-04-28,Cboe Options Exchange (C),3715617,657174,1397828131.000000,3792095,967353,9914792628.000000,7507712,1624527,11312620759.000000
2025-04-28,MIAX Emerald (D),1598489,265207,522313750.000000,0,0,0.000000,1598489,265207,522313750.000000
2025-04-28,Cboe EDGX Options Exchange (E),2840024,514395,684636394.000000,0,0,0.000000,2840024,514395,684636394.000000
2025-04-28,Nasdaq GEMX (H),2387072,331566,569907623.000000,356,180,17683610.000000,2387428,331746,587591233.000000
2025-04-28,Nasdaq ISE (I),2757500,442040,1146113745.000000,30185,11261,134330803.000000,2787685,453301,1280444548.000000
2025-04-28,Nasdaq MRX (J),1505245,208917,391994735.000000,0,0,0.000000,1505245,208917,391994735.000000
2025-04-28,MIAX Options Exchange (M),3151791,514200,914485357.000000,0,0,0.000000,3151791,514200,914485357.000000
2025-04-28,NYSE Arca Options (N),4545275,665496,1908434474.000000,0,0,0.000000,4545275,665496,1908434474.000000
2025-04-28,MIAX Pearl (P),1116219,160724,287056343.000000,0,0,0.000000,1116219,160724,287056343.000000
2025-04-28,NASDAQ Options Market (Q),1942206,287889,648482123.000000,0,0,0.000000,1942206,287889,648482123.000000
2025-04-28,MIAX Sapphire (S),1539807,215924,414971550.000000,0,0,0.000000,1539807,215924,414971550.000000
2025-04-28,Nasdaq BX Options (T),744055,81529,171596796.000000,0,0,0.000000,744055,81529,171596796.000000
2025-04-28,Members Exchange (U),1472087,200946,374307425.000000,0,0,0.000000,1472087,200946,374307425.000000
2025-04-28,Cboe C2 Options Exchange (W),1302062,166777,315557180.000000,9083,2756,20286259.000000,1311145,169533,335843439.000000
2025-04-28,Nasdaq PHLX (X),3989699,416398,1489105173.000000,32151,13989,227914293.000000,4021850,430387,1717019466.000000
2025-04-28,Cboe BZX Options Exchange (Z),1579488,218921,554229172.000000,1432,385,5319339.000000,1580920,219306,559548511.000000
2025-04-25,NYSE American Options (A),2500622,308891,832058879.000000,0,0,0.000000,2500622,308891,832058879.000000
2025-04-25,BOX Options (B),4046354,502165,1135949774.000000,0,0,0.000000,4046354,502165,1135949774.000000
2025-04-25,Cboe Options Exchange (C),5590119,877340,2066478215.000000,4296672,1008956,10232924674.000000,9886791,1886296,12299402889.000000
2025-04-25,MIAX Emerald (D),2385262,382510,762279681.000000,0,0,0.000000,2385262,382510,762279681.000000
2025-04-25,Cboe EDGX Options Exchange (E),4749121,608153,1108428592.000000,0,0,0.000000,4749121,608153,1108428592.000000
2025-04-25,Nasdaq GEMX (H),3005353,386788,670925632.000000,170,113,7606275.000000,3005523,386901,678531907.000000
2025-04-25,Nasdaq ISE (I),3950481,577545,1563661703.500000,29094,10827,175105800.000000,3979575,588372,1738767503.500000
2025-04-25,Nasdaq MRX (J),1987873,258976,419270292.000000,0,0,0.000000,1987873,258976,419270292.000000
2025-04-25,MIAX Options Exchange (M),4251225,665408,1296911213.000000,0,0,0.000000,4251225,665408,1296911213.000000
2025-04-25,NYSE Arca Options (N),6403938,861763,2384646401.000000,1,1,300.000000,6403939,861764,2384646701.000000
2025-04-25,MIAX Pearl (P),1355633,172921,276959564.000000,0,0,0.000000,1355633,172921,276959564.000000
2025-04-25,NASDAQ Options Market (Q),2623955,374494,792012427.500000,0,0,0.000000,2623955,374494,792012427.500000
2025-04-25,MIAX Sapphire (S),1992828,283204,551740584.000000,0,0,0.000000,1992828,283204,551740584.000000
2025-04-25,Nasdaq BX Options (T),977830,103438,169927552.000000,0,0,0.000000,977830,103438,169927552.000000
2025-04-25,Members Exchange (U),2064782,252673,434986361.000000,0,0,0.000000,2064782,252673,434986361.000000
2025-04-25,Cboe C2 Options Exchange (W),1863473,232625,563170187.000000,11514,2977,22782411.000000,1874987,235602,585952598.000000
2025-04-25,Nasdaq PHLX (X),5153487,483421,1914992070.000000,29392,12934,245405883.000000,5182879,496355,2160397953.000000
2025-04-25,Cboe BZX Options Exchange (Z),2235930,292562,629746736.000000,1145,285,4446012.000000,2237075,292847,634192748.000000
2025-04-24,NYSE American Options (A),2513204,274925,671564079.000000,0,0,0.000000,2513204,274925,671564079.000000
2025-04-24,BOX Options (B),3506027,425649,1566669607.000000,0,0,0.000000,3506027,425649,1566669607.000000
2025-04-24,Cboe Options Exchange (C),4972030,761689,2609018130.000000,4261021,999458,12034735706.000000,9233051,1761147,14643753836.000000
2025-04-24,MIAX Emerald (D),1794003,292703,572371135.000000,0,0,0.000000,1794003,292703,572371135.000000
2025-04-24,Cboe EDGX Options Exchange (E),3614628,553689,870082486.000000,0,0,0.000000,3614628,553689,870082486.000000
2025-04-24,Nasdaq GEMX (H),2634894,371565,667362365.000000,217,161,8866437.000000,2635111,371726,676228802.000000
2025-04-24,Nasdaq ISE (I),2916789,484085,1123699280.000000,23452,10576,170693075.000000,2940241,494661,1294392355.000000
2025-04-24,Nasdaq MRX (J),1662695,235884,370903707.000000,0,0,0.000000,1662695,235884,370903707.000000
2025-04-24,MIAX Options Exchange (M),3245944,544018,930561792.000000,0,0,0.000000,3245944,544018,930561792.000000
2025-04-24,NYSE Arca Options (N),5487371,691832,2050954363.000000,0,0,0.000000,5487371,691832,2050954363.000000
2025-04-24,MIAX Pearl (P),1272809,175080,298163901.000000,0,0,0.000000,1272809,175080,298163901.000000
2025-04-24,NASDAQ Options Market (Q),2200919,310575,690893862.000000,0,0,0.000000,2200919,310575,690893862.000000
2025-04-24,MIAX Sapphire (S),1745248,235473,493423044.000000,0,0,0.000000,1745248,235473,493423044.000000
2025-04-24,Nasdaq BX Options (T),784316,87605,149609881.000000,0,0,0.000000,784316,87605,149609881.000000
2025-04-24,Members Exchange (U),1654430,223165,405938908.000000,0,0,0.000000,1654430,223165,405938908.000000
2025-04-24,Cboe C2 Options Exchange (W),1406531,176443,380710804.000000,8876,2395,19773895.000000,1415407,178838,400484699.000000
2025-04-24,Nasdaq PHLX (X),4369384,419367,2124344238.000000,26140,13280,240495684.000000,4395524,432647,2364839922.000000
2025-04-24,Cboe BZX Options Exchange (Z),1873384,246914,560987409.000000,1318,443,4438188.000000,1874702,247357,565425597.000000
2025-04-23,NYSE American Options (A),2315043,287585,777309091.000000,0,0,0.000000,2315043,287585,777309091.000000
2025-04-23,BOX Options (B),3695746,415589,1484538759.500000,0,0,0.000000,3695746,415589,1484538759.500000
2025-04-23,Cboe Options Exchange (C),5787261,965651,2512688625.000000,4643167,1021003,13871123402.000000,10430428,1986654,16383812027.000000
2025-04-23,MIAX Emerald (D),2216841,346891,738470507.000000,0,0,0.000000,2216841,346891,738470507.000000
2025-04-23,Cboe EDGX Options Exchange (E),3952533,606453,1142547689.000000,0,0,0.000000,3952533,606453,1142547689.000000
2025-04-23,Nasdaq GEMX (H),3172776,424966,864262173.000000,240,151,8221079.000000,3173016,425117,872483252.000000
2025-04-23,Nasdaq ISE (I),3650484,540445,1371437147.000000,24290,12292,302759034.000000,3674774,552737,1674196181.000000
2025-04-23,Nasdaq MRX (J),1866322,248413,465366476.000000,0,0,0.000000,1866322,248413,465366476.000000
2025-04-23,MIAX Options Exchange (M),3999314,636790,1281754699.000000,0,0,0.000000,3999314,636790,1281754699.000000
2025-04-23,NYSE Arca Options (N),7056651,853715,2572825407.000000,0,0,0.000000,7056651,853715,2572825407.000000
2025-04-23,MIAX Pearl (P),1541337,205400,414341519.000000,0,0,0.000000,1541337,205400,414341519.000000
2025-04-23,NASDAQ Options Market (Q),2840902,396782,920250686.300000,0,0,0.000000,2840902,396782,920250686.300000
2025-04-23,MIAX Sapphire (S),1912720,261170,565855995.000000,0,0,0.000000,1912720,261170,565855995.000000
2025-04-23,Nasdaq BX Options (T),899845,98656,196200985.000000,0,0,0.000000,899845,98656,196200985.000000
2025-04-23,Members Exchange (U),1977066,256343,500371923.000000,0,0,0.000000,1977066,256343,500371923.000000
2025-04-23,Cboe C2 Options Exchange (W),1599138,184809,415014504.000000,14681,3768,46148961.000000,1613819,188577,461163465.000000
2025-04-23,Nasdaq PHLX (X),3930354,366266,1377651027.500000,26244,13373,300836951.000000,3956598,379639,1678487978.500000
2025-04-23,Cboe BZX Options Exchange (Z),2274970,303797,711077705.000000,3070,786,17416687.000000,2278040,304583,728494392.000000
2025-04-22,NYSE American Options (A),2492295,283324,1015051876.000000,0,0,0.000000,2492295,283324,1015051876.000000
2025-04-22,BOX Options (B),3142129,374976,1659475881.000000,0,0,0.000000,3142129,374976,1659475881.000000
2025-04-22,Cboe Options Exchange (C),4878465,868624,1895297580.000000,4276785,1009984,12876752686.000000,9155250,1878608,14772050266.000000
2025-04-22,MIAX Emerald (D),1769326,304342,610030111.000000,0,0,0.000000,1769326,304342,610030111.000000
2025-04-22,Cboe EDGX Options Exchange (E),3618351,554106,1051005849.000000,0,0,0.000000,3618351,554106,1051005849.000000
2025-04-22,Nasdaq GEMX (H),2297608,291050,574358388.000000,287,198,11480270.000000,2297895,291248,585838658.000000
2025-04-22,Nasdaq ISE (I),2878722,458750,1278436477.000000,20223,9080,249423388.000000,2898945,467830,1527859865.000000
2025-04-22,Nasdaq MRX (J),1300121,185655,342600256.000000,0,0,0.000000,1300121,185655,342600256.000000
2025-04-22,MIAX Options Exchange (M),3335578,590916,1192338516.000000,0,0,0.000000,3335578,590916,1192338516.000000
2025-04-22,NYSE Arca Options (N),5758980,806547,2561627514.000000,0,0,0.000000,5758980,806547,2561627514.000000
2025-04-22,MIAX Pearl (P),1296268,181192,348295327.000000,0,0,0.000000,1296268,181192,348295327.000000
2025-04-22,NASDAQ Options Market (Q),2326127,348763,780176504.000000,0,0,0.000000,2326127,348763,780176504.000000
2025-04-22,MIAX Sapphire (S),1702652,237731,488882973.000000,0,0,0.000000,1702652,237731,488882973.000000
2025-04-22,Nasdaq BX Options (T),810734,88520,169171504.000000,0,0,0.000000,810734,88520,169171504.000000
2025-04-22,Members Exchange (U),1661201,224771,435554707.000000,0,0,0.000000,1661201,224771,435554707.000000
2025-04-22,Cboe C2 Options Exchange (W),1290975,160370,428080126.000000,9760,2676,24987354.000000,1300735,163046,453067480.000000
2025-04-22,Nasdaq PHLX (X),3491315,335322,1714818826.000000,25455,13144,317745994.000000,3516770,348466,2032564820.000000
2025-04-22,Cboe BZX Options Exchange (Z),1889319,260034,607217133.000000,2263,604,15231065.000000,1891582,260638,622448198.000000